1111111111111
10010000000C1
1000011111001
1P0011E000001
10C000C001111
1000C00000001
1000000000001
1000000000C01
1000000000001
1000000000C01
1000000000001
1000000000001
1111111111111