11111111111111
10C100000000C1
10100111111001
1P0E011E000001
11111111111111