1111111111111
 101000000C1
  100001111
   1P0E001
     1111